..........#
..........#
..........#
..........#
.....$....#
..........#
..........#
..........#
..........#
..........#
###########
.
.
###################################
