....................
.#####........#####.
.#................#.
.#................#.
.#...##########...#.
.#................#.
.#................#.
.#####........#####.
.........$..........
########....########
########....########
....................
.#####........#####.
.#................#.
.#................#.
.#...##########...#.
.#................#.
.#................#.
.#####........#####.
....................